changestatus	changestatus	prefix	3
updatecommands	updatecommands	prefix	3
goodnight	goodnight	prefix	3
sendmessage	sendmessage	prefix	3
updatesettings	updatesettings	prefix	3
updatesetting	updatesetting	prefix	3
addsetting	addsetting	prefix	3
purge	purge	prefix	2
restrict	restrictuser	prefix	2
unrestrict	unrestrictuser	prefix	2
oops	oops	prefix	1
commands	commands	prefix	1
help	help	prefix	1
roll	roll	prefix	1
r	roll	prefix	1
chip	chip	prefix	1
power	power	prefix	1
NCP	NCP	prefix	1
virus	virus	prefix	1
virusx	virusx	prefix	1
tag	tag	prefix	1
query	query	prefix	1
NPC	NPC	prefix	1
bond	bond	prefix	1
mysterydata	mysterydata	prefix	1
rulebook	rulebook	prefix	1
element	element	prefix	3
mysteryreward	mysteryreward	prefix	1